****************
*         *    *
*    *    *  ***
*    *    *    *
*    *    *    *
*    *  S *    *
*    *   E     *
****************
