****************
*         *    *
*    *    *  ***
*    *    *    *
*    * E  *    *
*    *    *    *
*S   *         *
****************
